...............
.___...........
._S_...........
.___...........
.___...........
.__o...........
._____o_______.
.___________E_.
._o^__________.
...............
