...............
...............
..vvvvvvvvvvv..
.>____o__EEE_<.
.>_S_>_>_EEE_<.
.>____o__EEE_<.
..^^^^^^^^^^^..
...............
...............
...............
