.___........EEE
._S_........EEE
.___......._o_.
._vv......___..
.._o_....___...
..___..._^^....
.._vv.._o_.....
..._o____......
..._____.......
....___........
